111111111111111111111111111111111
10P000000000000000000000000000001
1010101010010011000100C100CCC0C01
101010101C100100101010101000C0C01
10101010110001001010101010CCC0C01
10101C101010X1001C10101110C000C01
10111110100100110100101010CCC0C01
100000000000000000000000000000001
1E0000000C00000000000000000000001
111111111111111111111111111111111