1111111111111111111111
1E0C00011000000000C011
1110000000100C00000011
1C000011C0000011000001
1000001000111000000001
1P00100C00000C00001C01
1111111111111111111111