1111111111
1000000001
10C0000001
1EP0000001
1111111111